"filename", "language", "Dart", "comment", "blank", "total"
"c:\Users\Mobo\Desktop\smarket_repo\lib\core\constants\constant.dart", "Dart", 14, 1, 4, 19
"c:\Users\Mobo\Desktop\smarket_repo\lib\core\constants\pop_context.dart", "Dart", 10, 0, 4, 14
"c:\Users\Mobo\Desktop\smarket_repo\lib\core\routes\route.dart", "Dart", 25, 0, 2, 27
"c:\Users\Mobo\Desktop\smarket_repo\lib\data\controller\account_setting_controller.dart", "Dart", 9, 0, 3, 12
"c:\Users\Mobo\Desktop\smarket_repo\lib\data\function\get_info.dart", "Dart", 21, 0, 5, 26
"c:\Users\Mobo\Desktop\smarket_repo\lib\data\models\billingdetails.dart", "Dart", 16, 0, 0, 16
"c:\Users\Mobo\Desktop\smarket_repo\lib\data\models\customer.dart", "Dart", 8, 0, 2, 10
"c:\Users\Mobo\Desktop\smarket_repo\lib\data\models\get_home.dart", "Dart", 10, 0, 2, 12
"c:\Users\Mobo\Desktop\smarket_repo\lib\data\models\get_info.dart", "Dart", 8, 0, 2, 10
"c:\Users\Mobo\Desktop\smarket_repo\lib\data\models\get_msg.dart", "Dart", 6, 0, 2, 8
"c:\Users\Mobo\Desktop\smarket_repo\lib\data\models\get_sign_in.dart", "Dart", 10, 0, 2, 12
"c:\Users\Mobo\Desktop\smarket_repo\lib\data\models\invoice.dart", "Dart", 38, 0, 7, 45
"c:\Users\Mobo\Desktop\smarket_repo\lib\data\models\invoiceDetailes.dart", "Dart", 87, 1, 2, 90
"c:\Users\Mobo\Desktop\smarket_repo\lib\data\models\payment_detailes.dart", "Dart", 17, 0, 1, 18
"c:\Users\Mobo\Desktop\smarket_repo\lib\data\models\product_details.dart", "Dart", 26, 0, 1, 27
"c:\Users\Mobo\Desktop\smarket_repo\lib\data\models\supplier.dart", "Dart", 8, 0, 2, 10
"c:\Users\Mobo\Desktop\smarket_repo\lib\data\repository\auth_qr.dart", "Dart", 8, 0, 2, 10
"c:\Users\Mobo\Desktop\smarket_repo\lib\data\repository\delete_card.dart", "Dart", 5, 0, 2, 7
"c:\Users\Mobo\Desktop\smarket_repo\lib\data\repository\get_home.dart", "Dart", 8, 0, 4, 12
"c:\Users\Mobo\Desktop\smarket_repo\lib\data\repository\get_signin.dart", "Dart", 8, 0, 4, 12
"c:\Users\Mobo\Desktop\smarket_repo\lib\data\repository\post_account.dart", "Dart", 9, 19, 7, 35
"c:\Users\Mobo\Desktop\smarket_repo\lib\data\repository\post_card.dart", "Dart", 6, 0, 3, 9
"c:\Users\Mobo\Desktop\smarket_repo\lib\data\repository\put_account_settings_repo.dart", "Dart", 11, 0, 3, 14
"c:\Users\Mobo\Desktop\smarket_repo\lib\data\repository\put_checkout.dart", "Dart", 6, 0, 2, 8
"c:\Users\Mobo\Desktop\smarket_repo\lib\data\repository\save_money.dart", "Dart", 11, 0, 4, 15
"c:\Users\Mobo\Desktop\smarket_repo\lib\main.dart", "Dart", 16, 0, 5, 21
"c:\Users\Mobo\Desktop\smarket_repo\lib\pdf\pdf_api_web.dart", "Dart", 44, 16, 15, 75
"c:\Users\Mobo\Desktop\smarket_repo\lib\pdf\pdf_invoice_api.dart", "Dart", 223, 1, 21, 245
"c:\Users\Mobo\Desktop\smarket_repo\lib\pdf\utils.dart", "Dart", 5, 0, 1, 6
"c:\Users\Mobo\Desktop\smarket_repo\lib\presentation\screens\about.dart", "Dart", 57, 0, 3, 60
"c:\Users\Mobo\Desktop\smarket_repo\lib\presentation\screens\account_setting.dart", "Dart", 382, 224, 33, 639
"c:\Users\Mobo\Desktop\smarket_repo\lib\presentation\screens\addcard.dart", "Dart", 291, 4, 10, 305
"c:\Users\Mobo\Desktop\smarket_repo\lib\presentation\screens\billingtscreen.dart", "Dart", 118, 0, 12, 130
"c:\Users\Mobo\Desktop\smarket_repo\lib\presentation\screens\cart_produt.dart", "Dart", 617, 40, 13, 670
"c:\Users\Mobo\Desktop\smarket_repo\lib\presentation\screens\checkout.dart", "Dart", 237, 0, 4, 241
"c:\Users\Mobo\Desktop\smarket_repo\lib\presentation\screens\create_account.dart", "Dart", 258, 4, 14, 276
"c:\Users\Mobo\Desktop\smarket_repo\lib\presentation\screens\drawer_list_title.dart", "Dart", 33, 0, 3, 36
"c:\Users\Mobo\Desktop\smarket_repo\lib\presentation\screens\email_otp.dart", "Dart", 139, 2, 10, 151
"c:\Users\Mobo\Desktop\smarket_repo\lib\presentation\screens\empty_invoices.dart", "Dart", 68, 1, 4, 73
"c:\Users\Mobo\Desktop\smarket_repo\lib\presentation\screens\emptycard.dart", "Dart", 33, 0, 3, 36
"c:\Users\Mobo\Desktop\smarket_repo\lib\presentation\screens\homeScreen.dart", "Dart", 218, 22, 9, 249
"c:\Users\Mobo\Desktop\smarket_repo\lib\presentation\screens\invoices_screen.dart", "Dart", 45, 0, 5, 50
"c:\Users\Mobo\Desktop\smarket_repo\lib\presentation\screens\market_empty.dart", "Dart", 15, 0, 4, 19
"c:\Users\Mobo\Desktop\smarket_repo\lib\presentation\screens\not_found_qr.dart", "Dart", 71, 0, 5, 76
"c:\Users\Mobo\Desktop\smarket_repo\lib\presentation\screens\onboarding_screen.dart", "Dart", 252, 23, 12, 287
"c:\Users\Mobo\Desktop\smarket_repo\lib\presentation\screens\paymentdetails.dart", "Dart", 16, 0, 0, 16
"c:\Users\Mobo\Desktop\smarket_repo\lib\presentation\screens\paymentscreen.dart", "Dart", 89, 0, 4, 93
"c:\Users\Mobo\Desktop\smarket_repo\lib\presentation\screens\reset_password.dart", "Dart", 139, 0, 9, 148
"c:\Users\Mobo\Desktop\smarket_repo\lib\presentation\screens\save_money.dart", "Dart", 128, 2, 8, 138
"c:\Users\Mobo\Desktop\smarket_repo\lib\presentation\screens\scan_qr.dart", "Dart", 96, 15, 15, 126
"c:\Users\Mobo\Desktop\smarket_repo\lib\presentation\screens\search.dart", "Dart", 272, 0, 4, 276
"c:\Users\Mobo\Desktop\smarket_repo\lib\presentation\screens\select_card.dart", "Dart", 124, 0, 12, 136
"c:\Users\Mobo\Desktop\smarket_repo\lib\presentation\screens\selectaddcard.dart", "Dart", 291, 4, 10, 305
"c:\Users\Mobo\Desktop\smarket_repo\lib\presentation\screens\sign_in.dart", "Dart", 277, 5, 10, 292
"c:\Users\Mobo\Desktop\smarket_repo\lib\presentation\screens\splash_screen.dart", "Dart", 53, 1, 8, 62
"c:\Users\Mobo\Desktop\smarket_repo\lib\presentation\screens\support.dart", "Dart", 89, 0, 3, 92
"c:\Users\Mobo\Desktop\smarket_repo\lib\presentation\widgets\background.dart", "Dart", 114, 0, 4, 118
"c:\Users\Mobo\Desktop\smarket_repo\lib\presentation\widgets\billingwidget.dart", "Dart", 169, 3, 6, 178
"c:\Users\Mobo\Desktop\smarket_repo\lib\presentation\widgets\customAppBar.dart", "Dart", 49, 1, 5, 55
"c:\Users\Mobo\Desktop\smarket_repo\lib\presentation\widgets\customAppBar2.dart", "Dart", 49, 1, 5, 55
"c:\Users\Mobo\Desktop\smarket_repo\lib\presentation\widgets\delete_pop.dart", "Dart", 93, 0, 3, 96
"c:\Users\Mobo\Desktop\smarket_repo\lib\presentation\widgets\drawerHeader.dart", "Dart", 53, 1, 3, 57
"c:\Users\Mobo\Desktop\smarket_repo\lib\presentation\widgets\drawerListTitle.dart", "Dart", 54, 1, 5, 60
"c:\Users\Mobo\Desktop\smarket_repo\lib\presentation\widgets\homeBtn.dart", "Dart", 131, 15, 11, 157
"c:\Users\Mobo\Desktop\smarket_repo\lib\presentation\widgets\homeBtnClipPath.dart", "Dart", 21, 1, 8, 30
"c:\Users\Mobo\Desktop\smarket_repo\lib\presentation\widgets\homeBtnDecoration.dart", "Dart", 14, 1, 4, 19
"c:\Users\Mobo\Desktop\smarket_repo\lib\presentation\widgets\invoices_widget.dart", "Dart", 171, 3, 6, 180
"c:\Users\Mobo\Desktop\smarket_repo\lib\presentation\widgets\label.dart", "Dart", 73, 0, 5, 78
"c:\Users\Mobo\Desktop\smarket_repo\lib\presentation\widgets\logout_pop.dart", "Dart", 105, 0, 4, 109
"c:\Users\Mobo\Desktop\smarket_repo\lib\presentation\widgets\market_widget.dart", "Dart", 118, 0, 3, 121
"c:\Users\Mobo\Desktop\smarket_repo\lib\presentation\widgets\paymentwidget.dart", "Dart", 163, 0, 6, 169
"c:\Users\Mobo\Desktop\smarket_repo\lib\presentation\widgets\pop_for_back.dart", "Dart", 180, 4, 8, 192
"c:\Users\Mobo\Desktop\smarket_repo\lib\presentation\widgets\pop_for_scan.dart", "Dart", 144, 4, 9, 157
"c:\Users\Mobo\Desktop\smarket_repo\lib\presentation\widgets\selectcardwidget.dart", "Dart", 57, 3, 4, 64
"c:\Users\Mobo\Desktop\smarket_repo\lib\presentation\widgets\thankyou.dart", "Dart", 58, 0, 3, 61
"Total", "-", 6897, 423, 443, 7763